11111111111
11100011101
100C00PE111
11111111111