11111111111
1P100011101
100C000E111
11111111111