1111111111111
100C1C01E1111
1P00000001111
1111111111111