11111111111111111111111
1000000C000100000000001
1E000000111111000000001
10000000P11110000000001
10000000011110000000001
11111111111111111111111