11111111111111111111111
100000000P0000C00000001
1E00000C111111000000001
11111111111111111111111