11111111111111111111111
100000000P0000C0C000001
1E00000C1111110C0000001
100000000000000000XC001
10000000000000000000001
11111111111111111111111