1111111111111
1P00000000001
10001110C0001
1000111000X01
10C00000000E1
1111111111111